####################
#P..##..§....+..@..#
#..##..~~..####....#
#...⚙............ ..#
####################
