####################
#P..##..§....+..@..#
#..##..~~..####....#
#...⌂..............#
####################
