####################
#P..~~..§....+.....#
#..##..~~..####....#
#...............@..#
####################
