####################
#..~~..§....+....@.#
#..##..~~..####....#
#......P...........#
####################
